You are the ranger Thulmir and have just come across a stretch of forest that you have not explored in the decades of traveling across the continent. You naturally thought this impossible, as you are likely the greatest explorer or all time. Regardless, you are healthily skeptical of this forest and cautiously make your way through the dense undergrowth.

In your backpack you carry your trusty repeating crossbow and a sleeping potion you were recently awarded by your friend, the mad wizard.

ThePartyKiller
An Interactive Fiction by Andrew Lai
Release 1 / Serial number 220117 / Inform 7 build 6M62 (I6/v6.33 lib 6/12N) SD

Forest Path
This forest seems no different from the thousands of others you have traversed and cataloged in your time as an adventurer -- abundant in wildlife, the occasional magical beast charging towards you in a futile attempt to acquire dinner, patches of innocent-looking mushrooms, and more equally unexciting sights and sounds of the forest. However after a few hours of traveling, you hear something quite unusual.To the North you hear what can only be described as the echos of chaos. You hear the occasional breaking of glass, waves of laughter, explosions, and music reverberating through the trees.

>N
As you walk towards the open doors, the bouncer blocks your way. He says, "I can't find your magic signature on the list. Come back later when you get an invitation." 
 Just then you hear muffled mublings from the man roped around the pillar beside you. You turn towards him and somehow feel your minds connecting; you think he cast a spell to communicate with you. He says:

Are you the famous ranger Thulmir? It must be you you stick out here like a sore thumb. Listen to me closely. This is my castle, my home, I started this but it's gotten out of hand. This party has been going on for 3 WHOLE YEARS and I have tried every POSSIBLE WAY to get these AWFUL people out of my house! I will grant you riches BEYOND COMPREHENSION if you can just SHUT THIS PARTY DOWN. I'm begging you. Please help me. I just want a good night's sleep. In my fluffy bed. With my stuffed rhino. Here, I'll implant your name into the guest list so you can get in. Do EVERYTHING IN YOUR POWER to shut down this party

>S
Forest Path
To the North you hear what can only be described as the echos of chaos. You hear the occasional breaking of glass, waves of laughter, explosions, and music reverberating through the trees.

>look
Forest Path
To the North you hear what can only be described as the echos of chaos. You hear the occasional breaking of glass, waves of laughter, explosions, and music reverberating through the trees.

I beg your pardon?

>N
Parking lot

* * *

>n
Grand Entrance
You push towards the noise and eventually come across a clearing in the forest. In front of you is something you never though you would find this deep in the forest: a Castle fit to be seiged upon by the greatest of Elder Dragons. It seems to be built with beautiful white stone and has spires reaching deep into the skies as if they dared clouds to come near them. The space in front of the castle is a massive lot, filled to the brim with chariots, carriages, and rickshaws pulled by everything from winged Griffons to armored beetles the size of cows. They must have come through a portal to get here. Ahead of you, towards the castle's grand entrance, a steady stream of people are heading into the colossus-sized double doors and a steady stream of apparent drunks are heading out, propped up by servants and companions alike. You walk up to the castle entrance. A Bouncer stands guard beside the doors and strangely enough, a gnome is strapped snugly to one of the neighboring pillars by rope. There is a gag over his mouth. The open doors North of you seem welcoming.

The Bouncer wears a crisp black tuxedo and has arms the size of tree trunks. He wears a festive party hat atop his head (a stark contrast to his stiff demeanor) and carries some kind of magical tablet with runes glowing on the back.

The Gnome is unconscious in his bindings. For some reason nobody pays him any attention.

>n
As you walk towards the open doors, the bouncer blocks your way. He says, "I can't find your magic signature on the list. Come back later when you get an invitation." 

Just then you hear muffled mumblings from the man roped around the pillar beside you. You turn towards him and somehow feel your minds connecting; you think he cast a spell to communicate with you. Inside your head you hear:

Are you the famous ranger Thulmir? It must be you - you stick out here like a sore thumb. Listen to me closely. This is my castle, my home, I started this party but it's gotten out of hand. Let me tell you, it has been going on for TWELVE WHOLE YEARS and I have tried every POSSIBLE WAY to get these AWFUL people out of my house! I will grant you riches BEYOND COMPREHENSION if you can just SHUT THIS PARTY DOWN. I'm begging you. Please help me. I just want a good night's sleep. In my fluffy bed. With my stuffed rhino. Here, I'll implant your name into the guest list so you can get in

The Gnome closes his eyes for a moment and you see a bead of sweat trickle down his cheek. He opens his eyes and continues: Ok I put you in the system, the bouncer should let you in now. Do EVERYTHING IN YOUR POWER to shut down this party. Don't even hesitate to get voilent. I promise to maintain your reputation no matter WHAT happens.

>s
You feel bad for the Gnome, you should at least give it an effort

* * *

>N
After much deliberation you decide to help the poor Gnome. You've crashed parties before, how hard can it be? As you turn towards the Entry Hall, the Gnome contacts you again:

Wait wait wait! Get me down from here first!

You decide he's already caused you enough trouble for you today. You end the telepathic link and continue on your way. Furious muffling can be heard from the Gnome's general direction.

Grand Hall
Spread before you is the party of a lifetime. The music surrounds you like a blanket, smothering your senses with its awesome power. Partygoers dressed in stunning costumes of brilliant color and variety peruse through groups of singers, dancers, drinkers, and chatters of equally dazzling quality.  Above you a magical glass pane filters light into the hall. The west wing of the hall holds the dance floor and the band, the north wing holds the game corner, and the east wing holds the bar and buffet.

You stand there and take in your surroundings but all you can think about is why the hell you weren't invited. You also think it would be quite catastrophic in these close quarters if a brawl broke out.

* * *

>n
After much deliberation you decide to help the poor Gnome. You've crashed parties before, how hard can it be? As you turn towards the Entry Hall, the Gnome contacts you again:

Wait wait wait! Get me down from here first!

You decide he's already caused you enough trouble for you today. You end the telepathic link and continue on your way. Furious muffling can be heard from the Gnome's general direction.

Grand Hall
Spread before you is the party of a lifetime. The music surrounds you like a blanket, smothering your senses with its awesome power. Partygoers dressed in stunning costumes of brilliant color and variety peruse through groups of singers, dancers, drinkers, and chatters of equally dazzling quality. The west wing of the hall is the dance floor and the east wing is the bar and buffet.

You stand there and take in your surroundings but all you can think about is why the hell you weren't invited... You remember the last time in a situation like this. Some hotshot fighter thought he could beat you in a brawl. Shame the constibles had to come to shut the thing down.

You can pick out a head that stands out from the rest of the guests. He appears to be an orc and he does not look pretty, despite his best efforts.

You can also see some other partygoers here.

>attack partygoers
Violence isn't the answer to this one.

>brawl partygoers
Violence isn't the answer to this one.

* * *

>attack Orc
Violence isn't the answer to this one.

>attack orc
Violence isn't the answer to this one.

* * *

>n
You can't go that way.

>attack Orc
Violence isn't the answer to this one.

* * *

>attack orc
You walk up to the orc and immediately slap the drink he was enjoying to the ground. He turns to you and is initially confused. You can actually see the gears turning in his mind as the confusion turns to realization, and the realization turns to anger, and the anger turns to fury. He slams his fist into your face and you are sent flying backwards, slamming into a group of lovely ladies just trying to enjoy the evening. You notice you have just attracted the full attention of everyone around you. As if the crowd has practiced this, a ring of men appears around you and the orc as they give you space to exchange blows. One of the spectators speaks up:

You know the drill, first to knock out your opponent wins. Loser forfeits their slot on the guest list. Aaaaaand FIGHT!

Time slows down. You wonder, how did this happen? The ground vibrates as the orc begins charging towards you. Unafraid, you glance over your shoulder to see bags of coins changing hands as spectators predict the winner. When you turn back around, the Orc is just about breathing down your throat. Still in slow motion, you take a single perfect step to the right, steady yourself into a low martial stance, backed up by decades of training and practice, then lash out with your left leg, aiming for the orc's fragile kneecaps. The kick connects perfectly. The Orc's charge is promptly ended as his legs give out and his face slams into the floor with a resounding thud. Cheers erupt around you as coins once again change hands. Spectators crowd around you, slapping you on the back and giving their heartfelt congratulations. Someone offers you a mug of ale and while basking in the glory of your victory you drown it to thunderous applause. The party continues.

You realize you're way to sober for this mission, and down the mug of ale. It is deliciously warm.

>attack orc
You can't see any such thing.

* * *

>look
Grand Hall
Partygoers dressed in stunning costumes of brilliant color and variety peruse through groups of singers, dancers, drinkers, and chatters of equally dazzling quality.  Above you a magical glass pane filters light into the hall. The west wing of the hall is the dance floor, the north wing holds the game corner, and the east wing holds the bar and buffet.

You stand there and take in your surroundings but all you can think about is why the hell you weren't invited..

You can see some other partygoers here.

>w
Dance Floor
You stroll over to the dance floor where a group of bards play music for the party guests, who are approximating dancing on the wooden floors.

There are five musicians on the bandstand. You think you recognize the song they are currently playing. Who was it by? The Pillbugs?

* * *

>e
Bar And Buffet
Here is where everyone is getting their food and drink to be consumed at their leisure somewhere in the party.

The buffet table seems to be of elvish make, sturdy yet beautiful at the same time.

On buffet table is drink barrels.

>examine buffet table
On buffet table is drink barrels.

* * *

>w
Dance Floor
You stroll over to the dance floor where a group of bards play music for the party guests, who are approximating dancing on the wooden floors. The Grand Hall is to the East

Their instruments are also quite intricate pieces of art -- not the instruments of your everyday house band.

There are five bards on the bandstand. You think you recognize the song they are currently playing. Who was it by? The Pillbugs? They're quite good. You consider asking them to play your favorite song, "Mrs. Darkside" before continuing your quest.

>look
Dance Floor
You stroll over to the dance floor where a group of bards play music for the party guests, who are approximating dancing on the wooden floors.

There are five musicians on the bandstand. You think you recognize the song they are currently playing. Who was it by? The Pillbugs?

>attack instruments
You can't see any such thing.

>attack bandInstruments
You can't see any such thing.

* * *

>w
Dance Floor
You stroll over to the dance floor where a group of bards play music for the party guests, who are approximating dancing on the wooden floors. The Grand Hall is to the East

Their instruments are also quite intricate pieces of art -- not the instruments of your everyday house band.

There are five bards on the bandstand. You think you recognize the song they are currently playing. Who was it by? The Pillbugs? They're quite good. You consider asking them to play your favorite song, "Mrs. Darkside" before continuing your quest.

>ask bards about hi
You walk up to the bards and ask them politely to stop the music. They respond by cranking up the volume of their instruments

>punch bards
You don't think the crowd would take to well to hurting the bards.
 You think a better idea would be to break their instruments instead.

>attack instruments
You calmly walk up to the stage, starting at the left, and move from bard to bard, taking and smashing each of their instruments one by one. You can hear a collective gasp from the crowd as they realize what you are doing. After the last instrument is smashed into pieces, the drone of the party dies down to a whisper as the guests notice the absence of music. The relative silence is just becoming unbearable when the band leader steps forward and raises his fist up into the air. After a dramatic pause... he pulls out his powerful tenor from his soul and begins a powerful rendition of a fan favorite, Rohemian Bapsody. His band mates join him, then a woman in the front row lends her voice to the acapella, then her friends join her, then the whole dance floor, and soon enough, the thousands of party guests sing together in unison. It is truly inspiring. You forget what your mission is and have no choice but to join in on the singing. You are snapped back into reality when you are shoved off the stage by someone (you didn't catch who it was as you were caught up in the magic of the song), and you realize a barrier has been put up between you and the stage. From a secret passageway, servants bring out backup instruments just as majestic as the now destroyed ones.

After a truly inspiring rendition of Rohemian Bapsody, the band re-dons their instruments and picks up right where they left off before the acapella. The party continues.

>look
Dance Floor
You stroll over to the dance floor where a group of bards play music for the party guests, who are approximating dancing on the wooden floors.

The band members have by now managed to get out their spares but these instruments sound just as good as the damaged ones.

A shimmering magical barrier separates the bards from the dance floor. It appears this isn't their first rodeo.

>attack bards
There's no getting through that barrier without some powerful counter spells. Spells which you do not have the slighest inkling about.

>attack instruments
There's no getting through that barrier without some powerful counter spells. Spells which you do not have the slighest inkling about.

>ask bards about silence
You walk up to the bards and ask them politely to stop the music. They respond by cranking up the volume of their instruments

* * *

>w
Dance Floor
You stroll over to the dance floor where a group of bards play music for the party guests, who are approximating dancing on the wooden floors. The Grand Hall is to the East

Their instruments are also quite intricate pieces of art -- not the instruments of your everyday house band.

There are five bards on the bandstand. You think you recognize the song they are currently playing. Who was it by? The Pillbugs? They're quite good. You consider asking them to play your favorite song, "Mrs. Darkside" before continuing your quest.

>e
Grand Hall
Partygoers dressed in stunning costumes of brilliant color and variety peruse through groups of singers, dancers, drinkers, and chatters of equally dazzling quality. The west wing of the hall is the dance floor and the east wing is the bar and buffet.

You stand there and take in your surroundings but all you can think about is why the hell you weren't invited... You remember the last time in a situation like this. Some hotshot fighter thought he could beat you in a brawl. Shame the constibles had to come to shut the thing down.

You can pick out a head that stands out from the rest of the guests. He appears to be an orc and he does not look pretty, despite his best efforts.

You can also see some other partygoers here.

>e
Bar And Buffet
Here is where everyone is getting their food and drink to be consumed at their leisure somewhere in the party.

The buffet table seems to be of elvish make, sturdy yet beautiful at the same time.

On buffet table are drink barrels and food trays.

>take drink barrels
It is likely you will be mobbed by angry partygoers if you attempt to deprive them of their drink. Best to avoid that situation.

>take food trays
You spot a curiously delicious looking orderve on one of the trays and you start reaching for it but then remember the last time you ate something at one of these fancy parties. You decide against taking that chance.

>examine drink barrels
A series of barrels with convenient spigots sit atop the buffet table. You assume this is where all the drinks of the night are originating from. They appear to be made of a clear kind of crystal, as to grant guests a look at what they are consuming. The barrels have no tops.

>examine food trays
Beside the barrels of alcohol is a spread of nearly every food imaginable from crabcakes to roasted chesnuts. Fancy food doesn't particularly agree with your battle-hardened stomach so you pass it by.

>take sleeping potion
You remember you found a powerful sleeping potion in the dungeon of a wizard who'd gone mad. You take it out of your back pocket, uncork the vial, and roll a nat 20 for sleight of hand to pour some of it into each barrel. You then begin lounging about waiting to see its effects. Slowly but surely partygoers fall to the ground unconscious as the potion is spread through the party. As people fall into a deep slumber, servants pick them up and drag them to some unseen sleeping room but are eventually overwhelmed by the sheer number of people passing out on the floor. Recognizing a change in mood, the bards start playing a peaceful lullaby. Next to you you see a young woman yawn. You are one of those people who can't help but catch others" yawns so you bring up your hand and let out a big long yawn. As you bring your hand to your face, you feel a dampness touch your lips. You lick your now damp upper lip and taste a pleasant cinnamon. Then your eyes begin to droop... You think, why am I so tired? And you decide the chair you are slumped in is the absolute most comfortable chair you have ever sat in. The band's lullaby suddenly sounds like the most beautiful sound you have ever heard, brighter than an angel's harp, warmer than a fire on a winter's night, calmer than the waves of a forest's lake. And you pass out.

When you come to the party is back in full swing. The woman who you saw yawn was also just waking up. She says:

That was the best sleep I've had in years! Wow I feel so alive! Please you must share a drunk with us.

The woman stumbles back to her friends, who greet her with equally lively squeals then gesture you to join them.
You realize you're way to sober for this mission, and down the offered mug of ale. It is deliciously warm.

>w
Grand Hall
Partygoers dressed in stunning costumes of brilliant color and variety peruse through groups of singers, dancers, drinkers, and chatters of equally dazzling quality. The west wing of the hall is the dance floor and the east wing is the bar and buffet.

You stand there and take in your surroundings but all you can think about is why the hell you weren't invited... You remember the last time in a situation like this. Some hotshot fighter thought he could beat you in a brawl. Shame the constibles had to come to shut the thing down.

You can pick out a head that stands out from the rest of the guests. He appears to be an orc and he does not look pretty, despite his best efforts.

You can also see some other partygoers here.

>examine orc
This guy's face looks like it has been through an industrial grain mill and then patched up with woodcarver's glue. He has thighs the size of your torso and his shirt buttons look as though they are holding onto their companions for dear life. In short, you can take him easily.

>examine partygoers
You see nothing special about the other partygoers.

>attack orc
You walk up to the orc and immediately slap the drink he was enjoying to the ground. He turns to you and is initially confused. You can actually see the gears turning in his mind as the confusion turns to realization, and the realization turns to anger, and the anger turns to fury. He slams his fist into your face and you are sent flying backwards, slamming into a group of lovely ladies just trying to enjoy the evening. You notice you have just attracted the full attention of everyone around you. As if the crowd has practiced this, a ring of men appears around you and the orc as they give you space to exchange blows. One of the spectators speaks up:

You know the drill, first to knock out your opponent wins. Loser forfeits their slot on the guest list. Aaaaaand FIGHT!

Time slows down. You wonder, how did this happen? The ground vibrates as the orc begins charging towards you. Unafraid, you glance over your shoulder to see bags of coins changing hands as spectators predict the winner. When you turn back around, the Orc is just about breathing down your throat. Still in slow motion, you take a single perfect step to the right, steady yourself into a low martial stance, backed up by decades of training and practice, then lash out with your left leg, aiming for the orc's fragile kneecaps. The kick connects perfectly. The Orc's charge is promptly ended as his legs give out and his face slams into the floor with a resounding thud. Cheers erupt around you as coins once again change hands. Spectators crowd around you, slapping you on the back and giving their heartfelt congratulations. Someone offers you a mug of ale and while basking in the glory of your victory you drown it to thunderous applause. The party continues.

You're starting to enjoy yourself. Best not to offend anyone by not enjoying this drink. You down it in a swift gulp.

>e
Bar And Buffet
Here is where everyone is getting their food and drink to be consumed at their leisure somewhere in the party.

The buffet table seems to be of elvish make, sturdy yet beautiful at the same time.

On buffet table are drink barrels and food trays.

>w
Grand Hall
Partygoers dressed in stunning costumes of brilliant color and variety peruse through groups of singers, dancers, drinkers, and chatters of equally dazzling quality. The west wing of the hall is the dance floor and the east wing is the bar and buffet.

You stand there and take in your surroundings but all you can think about is why the hell you weren't invited...

You can see some other partygoers here.

>w
Dance Floor
You stroll over to the dance floor where a group of bards play music for the party guests, who are approximating dancing on the wooden floors. The Grand Hall is to the East

Their instruments are also quite intricate pieces of art -- not the instruments of your everyday house band.

There are five bards on the bandstand. You think you recognize the song they are currently playing. Who was it by? The Pillbugs? They're quite good. You consider asking them to play your favorite song, "Mrs. Darkside" before continuing your quest.

>examine instruments
The bards are playing the standard instruments you expect to find in a house band - a lute, a full drumset, a trumpet, a bass, a tuba.

>examine bards
Each of the five bards have their own stylish outfit that matches their fancy instruments. They all seem to be enjoying themselves thoroughly playing music for this party.

>attack bards
You've already tried to start one fight today, and we all know how that worked out...
 It would probably be a better idea to just destroy all their instruments.

>attack instruments
You calmly walk up to the stage, starting at the left, and move from bard to bard, taking and smashing each of their instruments one by one. You can hear a collective gasp from the crowd as they realize what you are doing. After the last instrument is smashed into pieces, the drone of the party dies down to a whisper as the guests notice the absence of music. The relative silence is just becoming unbearable when the band leader steps forward and raises his fist up into the air. After a dramatic pause... he pulls out his powerful tenor from his soul and begins a beautiful rendition of a fan favorite, Rohemian Bapsody. His band mates join him, then a woman in the front row lends her voice to the acapella, then her friends join her, then the whole dance floor, and soon enough, the thousands of party guests sing together in unison. It is truly inspiring. You forget what your mission is and have no choice but to join in on the singing. You are snapped back into reality when you are shoved off the stage by someone (you didn't catch who it was as you were caught up in the magic of the song), and you realize a barrier has been put up between you and the stage. From a secret passageway, servants bring out backup instruments just as majestic as the now destroyed ones.

After a truly inspiring rendition of Rohemian Bapsody, the band re-dons their instruments and picks up right where they left off before the acapella. The party continues.
After your third drink at this party, you realize something. You think, "This party is amazing, it's bringing people together to share in the joy of life, offering an escape from the harsh reality that exists outside the castle's double doors." What right do you have to shut this party down. Who cares if it continues? You gave the Gnome's request a heartfelt shot, an honorable attempt, an enthusiastic try, but the party's momentum proved to be to powerful. At that, you make your way over to the bar, and pour yourself another stout ale.

    *** The End ***

Would you like to RESTART, RESTORE a saved game, QUIT or UNDO the last command?

* * *

>e
Bar And Buffet
Here is where everyone is getting their food and drink to be consumed at their leisure somewhere in the party.

The buffet table seems to be of elvish make, sturdy yet beautiful at the same time.

On buffet table is drink barrels.

>w
Grand Hall
Partygoers dressed in stunning costumes of brilliant color and variety peruse through groups of singers, dancers, drinkers, and chatters of equally dazzling quality. The west wing of the hall is the dance floor and the east wing is the bar and buffet.

You stand there and take in your surroundings but all you can think about is why the hell you weren't invited... You remember the last time in a situation like this. Some hotshot fighter thought he could beat you in a brawl. Shame the constibles had to come to shut the thing down.

You can pick out a head that stands out from the rest of the guests. He appears to be an orc and he does not look pretty, despite his best efforts.

You can also see some other partygoers here.

>w
Dance Floor
You stroll over to the dance floor where a group of bards play music for the party guests, who are approximating dancing on the wooden floors. The Grand Hall is to the East

Their instruments are also quite intricate pieces of art -- not the instruments of your everyday house band.

There are five bards on the bandstand. You think you recognize the song they are currently playing. Who was it by? The Pillbugs? They're quite good. You consider asking them to play your favorite song, "Mrs. Darkside" before continuing your quest.

>attack instruments
You calmly walk up to the stage, starting at the left, and move from bard to bard, taking and smashing each of their instruments one by one. You can hear a collective gasp from the crowd as they realize what you are doing. After the last instrument is smashed into pieces, the drone of the party dies down to a whisper as the guests notice the absence of music. The relative silence is just becoming unbearable when the band leader steps forward and raises his fist up into the air. After a dramatic pause... he pulls out his powerful tenor from his soul and begins a beautiful rendition of a fan favorite, Rohemian Bapsody. His band mates join him, then a woman in the front row lends her voice to the acapella, then her friends join her, then the whole dance floor, and soon enough, the thousands of party guests sing together in unison. It is truly inspiring. You forget what your mission is and have no choice but to join in on the singing. You are snapped back into reality when you are shoved off the stage by someone (you didn't catch who it was as you were caught up in the magic of the song), and you realize a barrier has been put up between you and the stage. From a secret passageway, servants bring out backup instruments just as majestic as the now destroyed ones.

After a truly inspiring rendition of Rohemian Bapsody, the band re-dons their instruments and picks up right where they left off before the acapella. The party continues.

* * *

>examine orc
You see nothing special about orc.

* * *

>s
You're curious as to what's going on inside, turning back now would be a waste

>w
You can't go that way.

>e
You can't go that way.

>n
As you walk towards the open doors, the bouncer blocks your way. He says, "I can't find your magic signature on the list. Come back later when you get an invitation." 
 Just then you hear muffled mublings from the man roped around the pillar beside you. You turn towards him and somehow feel your minds connecting; you think he cast a spell to communicate with you. He says:

Are you the famous ranger Thulmir? It must be you you stick out here like a sore thumb. Listen to me closely. This is my castle, my home, I started this but it's gotten out of hand. This party has been going on for 3 WHOLE YEARS and I have tried every POSSIBLE WAY to get these AWFUL people out of my house! I will grant you riches BEYOND COMPREHENSION if you can just SHUT THIS PARTY DOWN. I'm begging you. Please help me. I just want a good night's sleep. In my fluffy bed. With my stuffed rhino. Here, I'll implant your name into the guest list so you can get in. Do EVERYTHING IN YOUR POWER to shut down this party

* * *

I beg your pardon?

>n
As you walk towards the open doors, the bouncer blocks your way. He says, "I can't find your magic signature on the list. Come back later when you get an invitation." 

Just then you hear muffled mublings from the man roped around the pillar beside you. You turn towards him and somehow feel your minds connecting; you think he cast a spell to communicate with you. Inside your head you hear:

Are you the famous ranger Thulmir? It must be you - you stick out here like a sore thumb. Listen to me closely. This is my castle, my home, I started this party but it's gotten out of hand. Let me tell you, it has been going on for TWELVE WHOLE YEARS and I have tried every POSSIBLE WAY to get these AWFUL people out of my house! I will grant you riches BEYOND COMPREHENSION if you can just SHUT THIS PARTY DOWN. I'm begging you. Please help me. I just want a good night's sleep. In my fluffy bed. With my stuffed rhino. Here, I'll implant your name into the guest list so you can get in. Do EVERYTHING IN YOUR POWER to shut down this party

The Gnome closes his eyes for a moment and you see a bead of sweat trickle down his cheek. He opens his eyes and continues: Ok I put you in the system, the bouncer should let you in now

>n
After much deliberation you decide to help the poor Gnome. You've crashed parties before, how hard can it be? As you turn towards the Entry Hall, the Gnome contacts you again:

Wait wait wait! Get me down from here first!

You decide he's already caused you enough trouble for you today. You end the telepathic link and continue on your way. Furious muffling can be heard from the Gnome's general direction.

Grand Hall
Spread before you is the party of a lifetime. The music surrounds you like a blanket, smothering your senses with its awesome power. Partygoers dressed in stunning costumes of brilliant color and variety peruse through groups of singers, dancers, drinkers, and chatters of equally dazzling quality.  Above you a magical glass pane filters light into the hall. The west wing of the hall holds the dance floor and the band, the north wing holds the game corner, and the east wing holds the bar and buffet.

You stand there and take in your surroundings but all you can think about is why the hell you weren't invited. You also think it would be quite catastrophic in these close quarters if a brawl broke out.

You can pick out a head that stands out from the rest of the partygoers. It appears to be an orc and he does not look pretty, despite his best efforts.

You can also see some partygoers here.

* * *

>examine party hat
The Bouncer wears a festive party hat atop his head (a stark contrast to his stiff demeanor).

>examine magical tablet
The Bouncer holds some kind of magical tablet with glowing runes on the back.

>n
As you walk towards the open doors, the bouncer blocks your way. He says, "I can't find your magic signature on the list. Come back later when you get an invitation." 

Just then you hear muffled mumblings from the man roped around the pillar beside you. You turn towards him and somehow feel your minds connecting; you think he cast a spell to communicate with you. Inside your head you hear:

Are you the famous ranger Thulmir? It must be you - you stick out here like a sore thumb. Listen to me closely. This is my castle, my home, I started this party but it's gotten out of hand. Let me tell you, it has been going on for TWELVE WHOLE YEARS and I have tried every POSSIBLE WAY to get these AWFUL people out of my house! I will grant you riches BEYOND COMPREHENSION if you can just SHUT THIS PARTY DOWN. I'm begging you. Please help me. I just want a good night's sleep. In my fluffy bed. With my stuffed rhino. Here, I'll implant your name into the guest list so you can get in

The Gnome closes his eyes for a moment and you see a bead of sweat trickle down his cheek. He opens his eyes and continues: Ok I put you in the system, the bouncer should let you in now. Do EVERYTHING IN YOUR POWER to shut down this party. Don't even hesitate to get voilent. I promise to maintain your reputation no matter WHAT happens.

* * *

>examine orc
This guy's face looks like it has been through an industrial grain mill and then patched up with woodcarver's glue. He has thighs the size of your torso and his shirt buttons look as though they are holding onto their companions for dear life.

>attack orc
You walk up to the orc and immediately slap the drink he was enjoying to the ground. He turns to you and is initially confused. You can actually see the gears turning in his mind as the confusion turns to realization, and the realization turns to anger, and the anger turns to fury. He slams his fist into your face and you are sent flying backwards, slamming into a group of lovely ladies just trying to enjoy the evening. You notice you have just attracted the full attention of everyone around you. As if the crowd has practiced this, a ring of men appears around you and the orc as they give you space to exchange blows. One of the spectators speaks up:

You know the drill, first to knock out your opponent wins. Loser forfeits their slot on the guest list. Aaaaaand FIGHT!

Time slows down. You wonder, how did this happen? The ground vibrates as the orc begins charging towards you. Unafraid, you glance over your shoulder to see bags of coins changing hands as spectators predict the winner. When you turn back around, the Orc is just about breathing down your throat. Still in slow motion, you take a single perfect step to the right, steady yourself into a low martial stance, backed up by decades of training and practice, then lash out with your left leg, aiming for the orc's fragile kneecaps. The kick connects perfectly. The Orc's charge is promptly ended as his legs give out and his face slams into the floor with a resounding thud. Cheers erupt around you as coins once again change hands. Spectators crowd around you, slapping you on the back and giving their heartfelt congratulations. Someone offers you a mug of ale and while basking in the glory of your victory you drown it to thunderous applause. The party continues.

>n
You can't go that way.

>s
That way is the exit, but you haven't completed your quest yet!

>w
Dance Floor
You stroll over to the dance floor where a group of bards play music for the party guests, who are approximating dancing on the wooden floors. The Grand Hall is to the East

There are five musicians on the bandstand. You think you recognize the song they are currently playing. Who was it by? The Pillbugs? They're quite good. You consider asking them to play your favorite song, "Mrs. Darkside" before continuing your quest.

You can also see instruments here.

>examine bards
You see nothing special about bards.

>attack instruments
You calmly walk up to the stage, starting at the left, and move from bard to bard, taking and smashing each of their instruments one by one. You can hear a collective gasp from the crowd as they realize what you are doing. After the last instrument is smashed into pieces, the drone of the party dies down to a whisper as the guests notice the absence of music. The relative silence is just becoming unbearable when the band leader steps forward and raises his fist up into the air. After a dramatic pause... he pulls out his powerful tenor from his soul and begins a beautiful rendition of a fan favorite, Rohemian Bapsody. His band mates join him, then a woman in the front row lends her voice to the acapella, then her friends join her, then the whole dance floor, and soon enough, the thousands of party guests sing together in unison. It is truly inspiring. You forget what your mission is and have no choice but to join in on the singing. You are snapped back into reality when you are shoved off the stage by someone (you didn't catch who it was as you were caught up in the magic of the song), and you realize a barrier has been put up between you and the stage. From a secret passageway, servants bring out backup instruments just as majestic as the now destroyed ones.

After a truly inspiring rendition of Rohemian Bapsody, the band re-dons their instruments and picks up right where they left off before the acapella. The party continues.

>w
You can't go that way.

>e
Grand Hall
Partygoers dressed in stunning costumes of brilliant color and variety peruse through groups of singers, dancers, drinkers, and chatters of equally dazzling quality. The west wing of the hall is the dance floor and the east wing is the bar and buffet.

You stand there and take in your surroundings but all you can think about is why the hell you weren't invited...

You can see some other partygoers here.

>e
Bar And Buffet
Here is where everyone is getting their food and drink to be consumed at their leisure somewhere in the party.

The buffet table seems to be of elvish make, sturdy yet beautiful at the same time.

On buffet table is drink barrels.

>hold sleeping potion
You remember you found a powerful sleeping potion in the dungeon of a wizard who'd gone mad. You take it out of your back pocket, uncork the vial, and roll a nat 20 for sleight of hand to pour some of it into each barrel. You then begin lounging about waiting to see its effects. Slowly but surely partygoers fall to the ground unconscious as the potion is spread through the party. As people fall into a deep slumber, servants pick them up and drag them to some unseen sleeping room but are eventually overwhelmed by the sheer number of people passing out on the floor. Recognizing a change in mood, the bards start playing a peaceful lullaby. Next to you you see a young woman yawn. You are one of those people who can't help but catch others" yawns so you bring up your hand and let out a big long yawn. As you bring your hand to your face, you feel a dampness touch your lips. You lick your now damp upper lip and taste a pleasant cinnamon. Then your eyes begin to droop... You think, why am I so tired? And you decide the chair you are slumped in is the absolute most comfortable chair you have ever sat in. The band's lullaby suddenly sounds like the most beautiful sound you have ever heard, brighter than an angel's harp, warmer than a fire on a winter's night, calmer than the waves of a forest's lake. And you pass out.

When you come to the party is back in full swing. The woman who you saw yawn was also just waking up. She says:

That was the best sleep I've had in years! Wow I feel so alive!

The woman stumbles back to her friends, who greet her with equally lively squeals. The party continues.

* * *

>s
Your ranger senses indicate there isn't anything interesting over there, just more boring forest

>w
There isn't anything interesting over there, just more forest

>e
There isn't anything interesting over there, just more forest

>n
Grand Entrance
You push towards the noise and eventually come across a clearning in the forest. In front of you is something you never though you would find this deep in the forest: a Castle. It seems to be built with white stone with spires reaching up to the skies. The space in front of the castle is a massive parking lot, filled to the brim with chariots, carriages, and rickshaws pulled by everything from winged Gryffons to armored beetles the size of cows. They must have come through a portal to get here. Ahead of you, towards the castle's grand entrance, a steady stream of people are heading into the colossus-sized double doors and a steady stream of apparent drunks are heading out, propped up by servants and companions alike.You walk up to the castle entrance. A Bouncer stands guard beside the doors and strangely enough, a gnome is strapped snugly to one of the neighboring pillars by rope. There is a gag over his mouth. The open doors North of you seem welcoming.

The Bouncer wears a crisp black tuxedo and has arms the size of tree trunks. He wears a party hat atop his head and carries a magical tablet.

The Gnome is unconscious in his bindings. For some reason nobody pays him any attention.

* * *

>s
Your ranger senses indicate there isn't anything interesting over there, just more boring forest

>n
Grand Entrance
You push towards the noise and eventually come across a clearning in the forest. In front of you is something you never though you would find this deep in the forest: a Castle. It seems to be built with white stone with spires reaching up to the skies. The space in front of the castle is a massive parking lot, filled to the brim with chariots, carriages, and rickshaws pulled by everything from winged Gryffons to armored beetles the size of cows. They must have come through a portal to get here. Ahead of you, towards the castle's grand entrance, a steady stream of people are heading into the colossus-sized double doors and a steady stream of apparent drunks are heading out, propped up by servants and companions alike.You walk up to the castle entrance. A Bouncer stands guard beside the doors and strangely enough, a gnome is strapped snugly to one of the neighboring pillars by rope. There is a gag over his mouth. The open doors North of you seem welcoming.

The Bouncer wears a crisp black tuxedo and has arms the size of tree trunks. He wears a party hat atop his head and carries a magical tablet.

The Gnome is unconscious in his bindings. For some reason nobody pays him any attention.

>s
You're curious as to what's going on inside, turning back now would be a waste

>w
You're curious as to what's going on inside, turning back now would be a waste

>e
You're curious as to what's going on inside, turning back now would be a waste

>n
As you walk towards the open doors, the bouncer blocks your way. He says, "I can't find your magic signature on the list. Come back later when you get an invitation." 

 Just then you hear muffled mublings from the man roped around the pillar beside you. You turn towards him and somehow feel your minds connecting; you think he cast a spell to communicate with you. He says:

Are you the famous ranger Thulmir? It must be you you stick out here like a sore thumb. Listen to me closely. This is my castle, my home, I started this but it's gotten out of hand. This party has been going on for 3 WHOLE YEARS and I have tried every POSSIBLE WAY to get these AWFUL people out of my house! I will grant you riches BEYOND COMPREHENSION if you can just SHUT THIS PARTY DOWN. I'm begging you. Please help me. I just want a good night's sleep. In my fluffy bed. With my stuffed rhino. Here, I'll implant your name into the guest list so you can get in. Do EVERYTHING IN YOUR POWER to shut down this party

>s
You feel bad for the Gnome, you should at least give it an effort

>w
You feel bad for the Gnome, you should at least give it an effort

>e
You feel bad for the Gnome, you should at least give it an effort

>n
Entry Hall

* * *

>w
Your ranger senses indicate there isn't anything interesting over there, just more boring forest

>n
Grand Entrance
You push towards the noise and eventually come across a clearning in the forest. In front of you is something you never though you would find this deep in the forest: a Castle. It seems to be built with white stone with spires reaching up to the skies. The space in front of the castle is a massive parking lot, filled to the brim with chariots, carriages, and rickshaws pulled by everything from winged Gryffons to armored beetles the size of cows. They must have come through a portal to get here. Ahead of you, towards the castle's grand entrance, a steady stream of people are heading into the colossus-sized double doors and a steady stream of apparent drunks are heading out, propped up by servants and companions alike. You walk up to the castle entrance. A Bouncer stands guard beside the doors and strangely enough, a gnome is strapped snugly to one of the neighboring pillars by rope. There is a gag over his mouth. The open doors North of you seem welcoming.

The Bouncer wears a crisp black tuxedo and has arms the size of tree trunks. He wears a party hat atop his head and carries a magical tablet.

The Gnome is unconscious in his bindings. For some reason nobody pays him any attention.

>n
As you walk towards the open doors, the bouncer blocks your way. He says, "I can't find your magic signature on the list. Come back later when you get an invitation." 

Just then you hear muffled mublings from the man roped around the pillar beside you. You turn towards him and somehow feel your minds connecting; you think he cast a spell to communicate with you. Inside your head you hear:

Are you the famous ranger Thulmir? It must be you - you stick out here like a sore thumb. Listen to me closely. This is my castle, my home, I started this party but it's gotten out of hand. Let me tell you, it has been going on for TWELVE WHOLE YEARS and I have tried every POSSIBLE WAY to get these AWFUL people out of my house! I will grant you riches BEYOND COMPREHENSION if you can just SHUT THIS PARTY DOWN. I'm begging you. Please help me. I just want a good night's sleep. In my fluffy bed. With my stuffed rhino. Here, I'll implant your name into the guest list so you can get in. Do EVERYTHING IN YOUR POWER to shut down this party

The Gnome closes his eyes for a moment and you see a bead of sweat trickle down his cheek. He opens his eyes and continues: Ok I put you in the system, the bouncer should let you in now

>w
You feel bad for the Gnome, you should at least give it an effort

>n
After much deliberation you decide to help the poor Gnome. You've crashed parties before, how hard can it be? As you turn towards the Entry Hall, the Gnome contacts you again:

Wait wait wait! Get me down from here first!

You decide he's already caused you enough trouble for you today. You end the telepathic link and continue on your way. Furious muffling can be heard from the Gnome's general direction.

Grand Hall
Spread before you is the party of a lifetime. The music surrounds you like a blanket, smothering your senses with its awesome power. Partygoers dressed in stunning costumes of brilliant color and variety peruse through groups of singers, dancers, drinkers, and chatters of equally dazzling quality.  Above you a magical glass pane filters light into the hall. The west wing of the hall holds the dance floor and the band, the north wing holds the game corner, and the east wing holds the bar and buffet.

You stand there and take in your surroundings but all you can think about is why the hell you weren't invited. You also think it would be quite catastrophic in these close quarters if a brawl broke out.

You can see Partygoer here.

* * *

>n
After much deliberation you decide to help the poor Gnome. You've crashed parties before, how hard can it be? As you turn towards the Entry Hall, the Gnome contacts you again:

Wait wait wait! Get me down from here first!

You decide he's already caused you enough trouble for you today. You end the telepathic link and continue on your way. Furious muffling can be heard from the Gnome's general direction.

Grand Hall
Spread before you is the party of a lifetime. The music surrounds you like a blanket, smothering your senses with its awesome power. Partygoers dressed in stunning costumes of brilliant color and variety peruse through groups of singers, dancers, drinkers, and chatters of equally dazzling quality.  Above you a magical glass pane filters light into the hall. The west wing of the hall is the dance floor and the east wing is the bar and buffet.

You stand there and take in your surroundings but all you can think about is why the hell you weren't invited... You also think it would be quite catastrophic in these close quarters if a brawl broke out

You can pick out a head that stands out from the rest of the guests. He appears to be an orc and he does not look pretty, despite his best efforts.

You can also see some other partygoers here.

>w
Dance Floor
You stroll over to the dance floor where a group of bards play music for the party guests, who are approximating dancing on the wooden floors. The Grand Hall is to the East.

The bards are playing the standard instruments you expect to find in a house band - a lute, a full drumset, a trumpet, a bass, a tuba.

There are five musicians on the bandstand. You think you recognize the song they are currently playing. Who was it by? The Pillbugs?

>e
Grand Hall
Partygoers dressed in stunning costumes of brilliant color and variety peruse through groups of singers, dancers, drinkers, and chatters of equally dazzling quality.  Above you a magical glass pane filters light into the hall. The west wing of the hall is the dance floor and the east wing is the bar and buffet.

You stand there and take in your surroundings but all you can think about is why the hell you weren't invited... You also think it would be quite catastrophic in these close quarters if a brawl broke out

You can pick out a head that stands out from the rest of the guests. He appears to be an orc and he does not look pretty, despite his best efforts.

You can also see some other partygoers here.

>e
Bar And Buffet
Here is where everyone is getting their food and drink to be consumed at their leisure somewhere in the party.

A series of barrels with convenient spigots sit atop the buffet table. You assume this is where all the drinks of the night are originating from. The barrels have no tops.

You can see buffet table here.

>inventory
You are carrying:
  repeating crossbow
  sleeping potion

>use sleeping potion
That's not a verb I recognise.

>take sleeping potion
You remember you found a powerful sleeping potion in the dungeon of a wizard who'd gone mad. You take it out of your back pocket, uncork the vial, and roll a nat 20 for sleight of hand to pour some of it into each barrel. You then begin lounging about waiting to see its effects. Slowly but surely partygoers fall to the ground unconscious as the potion is spread through the party. As people fall into a deep slumber, servants pick them up and drag them to some unseen sleeping room but are eventually overwhelmed by the sheer number of people passing out on the floor. Recongizing a change in mood, the bards start playing a peaceful lulaby. Next to you you see a young woman yawn. You are one of those people who can't help but catch others" yawns so you bring up your hand and let out a big long yawn. As you bring your hand to your face, you feel a dampness touch your lips. You lick your now damp upper lip and taste a pleasant cinammon. Then your eyes begin to droop... You think, why am I so tired? And you decide the chair you are slumped in is the absolute most comfortable chair you have ever sat in. The band's lulaby suddenly sounds like the most beautiful sound you have ever heard, brighter than an angel's harp, warmer than a fire on a winter's night, calmer than the waves of a forest's lake. And you pass out.

When you come to the party is back in full swing. The woman who you saw yawn was also just waking up. She says:

That was the best sleep I've had in years! Wow I feel so alive!

The woman stumbles back to her friends, who greet her with equally lively squeals. The party continues.

* * *

>w
Your ranger senses indicate there isn't anything interesting over there, just more boring forest

>w
Your ranger senses indicate there isn't anything interesting over there, just more boring forest

* * *

>n
After much deliberation you decide to help the poor Gnome. You've crashed parties before, how hard can it be? As you turn towards the Entry Hall, the Gnome contacts you again:

Wait wait wait! Get me down from here first!

You decide he's already caused you enough trouble for you today. You end the telepathic link and continue on your way. Furious muffling can be heard from the Gnome's general direction.

Grand Hall
Spread before you is the party of a lifetime. The music surrounds you like a blanket, smothering your senses with its awesome power. Partygoers dressed in stunning costumes of brilliant color and variety peruse through groups of singers, dancers, drinkers, and chatters of equally dazzling quality.  Above you a magical glass pane filters light into the hall. The west wing of the hall holds the dance floor and the band, the north wing holds the game corner, and the east wing holds the bar and buffet.

You stand there and take in your surroundings but all you can think about is why the hell you weren't invited. You also think it would be quite catastrophic in these close quarters if a brawl broke out.

You can see some partygoers here.

* * *

>w
Your ranger senses indicate there isn't anything interesting over there, just more boring forest

>n
Grand Entrance
You push towards the noise and eventually come across a clearing in the forest. In front of you is something you never though you would find this deep in the forest: a Castle fit to be seiged upon by the greatest of Elder Dragons. It seems to be built with beautiful white stone and has spires reaching deep into the skies as if they dared clouds to come near them. The space in front of the castle is a massive lot, filled to the brim with chariots, carriages, and rickshaws pulled by everything from winged Griffons to armored beetles the size of cows. They must have come through a portal to get here. Ahead of you, towards the castle's grand entrance, a steady stream of people are heading into the colossus-sized double doors and a steady stream of apparent drunks are heading out, propped up by servants and companions alike. You walk up to the castle entrance. A Bouncer stands guard beside the doors and strangely enough, a gnome is strapped snugly to one of the neighboring pillars by rope. There is a gag over his mouth. The open doors North of you seem welcoming.

The Bouncer wears a crisp black tuxedo and has arms the size of tree trunks. He wears a festive party hat atop his head (a stark contrast to his stiff demeanor) and carries some kind of magical tablet with runes glowing on the back.

The Gnome is unconscious in his bindings. For some reason nobody pays him any attention.

* * *

I beg your pardon?

>n
As you walk towards the open doors, the bouncer blocks your way. He says, "I can't find your magic signature on the list. Come back later when you get an invitation." 

Just then you hear muffled mumblings from the man roped around the pillar beside you. You turn towards him and somehow feel your minds connecting; you think he cast a spell to communicate with you. Inside your head you hear:

Are you the famous ranger Thulmir? It must be you - you stick out here like a sore thumb. Listen to me closely. This is my castle, my home, I started this party but it's gotten out of hand. Let me tell you, it has been going on for TWELVE WHOLE YEARS and I have tried every POSSIBLE WAY to get these AWFUL people out of my house! I will grant you riches BEYOND COMPREHENSION if you can just SHUT THIS PARTY DOWN. I'm begging you. Please help me. I just want a good night's sleep. In my fluffy bed. With my stuffed rhino. Here, I'll implant your name into the guest list so you can get in

The Gnome closes his eyes for a moment and you see a bead of sweat trickle down his cheek. He opens his eyes and continues: Ok I put you in the system, the bouncer should let you in now. Do EVERYTHING IN YOUR POWER to shut down this party. Don't even hesitate to get voilent. I promise to maintain your reputation no matter WHAT happens.

* * *

>inventory
You are carrying:
  repeating crossbow
  sleeping potion

>pour vial
That's not a verb I recognise.

>pour
That's not a verb I recognise.

* * *

>inventory
You are carrying:
  repeating crossbow
  sleeping potion

>examine sleeping potion
You remember the wizard explaining this potion to you. He was hired to neutralize the entirety of a warlords army. So, he devised a plan to poison their water supply with these highly concentrated potions that could each put the whole army to sleep with just one pour.

* * *

>take sleeping potion
You hear Professor Oak's voice echo in your head. There is a time and place for everything...

>use sleeping potion
That's not a verb I recognise.

>hold sleeping potion
You hear Professor Oak's voice echo in your head. There is a time and place for everything...

>examine sleeping potion
You see nothing special about sleeping potion.

* * *

>examine sleeping potion
You see nothing special about sleeping potion.

* * *

I beg your pardon?

I beg your pardon?

>n
Grand Entrance
You push towards the noise and eventually come across a clearing in the forest. In front of you is something you never though you would find this deep in the forest: a Castle fit to be seiged upon by the greatest of Elder Dragons. It seems to be built with beautiful white stone and has spires reaching deep into the skies as if they dared clouds to come near them. The space in front of the castle is a massive lot, filled to the brim with chariots, carriages, and rickshaws pulled by everything from winged Griffons to armored beetles the size of cows. They must have come through a portal to get here. Ahead of you, towards the castle's grand entrance, a steady stream of people are heading into the colossus-sized double doors and a steady stream of apparent drunks are heading out, propped up by servants and companions alike. You walk up to the castle entrance. A Bouncer stands guard beside the doors and strangely enough, a gnome is strapped snugly to one of the neighboring pillars by rope. There is a gag over his mouth. The open doors North of you seem welcoming.

The Bouncer wears a crisp black tuxedo and has arms the size of tree trunks. He wears a festive party hat atop his head (a stark contrast to his stiff demeanor) and carries some kind of magical tablet with runes glowing on the back.

The Gnome is unconscious in his bindings. For some reason nobody pays him any attention.

* * *

>e
Bar And Buffet
Here is where everyone is getting their food and drink to be consumed at their leisure somewhere in the party.

The buffet table seems to be of elvish make, sturdy yet beautiful at the same time.

On buffet table are drink barrels and food trays.

>examine buffet table
The buffet table is probably the largest you have ever seen. Upon further inspection it appears to be carved out of a single tree, a marvel of craftsmanship. Atop it are food trays and drink barrels.

On buffet table are drink barrels and food trays.

>examine food trays
Beside the barrels of alcohol is a spread of nearly every food imaginable from crabcakes to roasted chesnuts. Fancy food doesn't particularly agree with your battle-hardened stomach so you pass it by.

>take food trays
You spot a curiously delicious looking orderve on one of the trays and you start reaching for it but then remember the last time you ate something at one of these fancy parties. You decide against taking that chance.

* * *

>examine drink barrels
A series of barrels with convenient spigots sit atop the buffet table. You assume this is where all the drinks of the night are originating from. They appear to be made of a clear kind of crystal, as to grant guests a look at what they are consuming. The barrels have no tops.

>take drink barrels
Taken.